111111111111111111111111111111111111111111111111
1011C0000000000000000000000000000000000000000001
1P0CC1111100000000000000000000000000000000000001
100CC1111100000000000000000000000000000000000001
100CC1111100000000000000000000000000000000000001
100CC1111100000000000000000000000000000000000001
100CC1111100000000000000000000000000000000000001
100CC1111100000000000000000000000000000000000001
100CC1111100000000000000000000000000000000000001
100CC1111100000000000000000000000000000000000001
1C0CC1111100000000000000000000000000000000000001
100CC1111100000000000000000000000000000000000001
100011E00000000000000000000000000000000000000001
111111111111111111111111111111111111111111111111